mapa tres
X,X,X,X,X,X,X,X,X,X,X,X,X
X,X,A,A,A,A,A,A,A,A,A,X,X
X,X,A,A,A,A,A,A,A,A,A,X,X
X,X,A,A,A,A,A,A,A,A,A,X,X
X,X,X,X,X,X,X,X,X,X,X,X,X
X,X,A,A,A,A,A,A,A,A,A,X,X
X,X,A,A,A,A,A,A,A,A,A,X,X
X,X,A,A,A,A,A,A,A,A,A,X,X
X,X,X,X,X,X,X,X,X,X,X,X,X
X,X,X,X,X,B,B,B,X,X,X,X,X
X,X,X,B,B,B,B,B,B,B,X,X,X
X,X,A,A,A,A,A,A,A,A,A,X,X
X,X,A,A,A,A,A,A,A,A,A,X,X
X,X,A,A,A,A,A,A,A,A,A,X,X
X,X,X,X,X,X,X,X,X,X,X,X,X
X,X,X,X,X,X,X,X,X,X,X,X,X
X,X,X,X,X,X,X,X,X,X,X,X,X
X,X,X,X,X,X,X,X,X,X,X,X,X