mapa dos
X,X,X,X,X,X,X,X,X,X,X,X,X
X,X,A,X,X,X,X,X,X,X,A,X,X
A,A,A,A,A,X,X,X,A,A,A,A,A
X,A,A,A,X,X,X,X,X,A,A,A,X
X,X,A,X,X,X,X,X,X,X,A,X,X
X,X,X,X,X,X,A,X,X,X,X,X,X
X,X,X,X,A,A,B,A,A,X,X,X,X
X,X,X,X,A,B,C,B,A,X,X,X,X
X,X,X,A,B,C,C,C,B,A,X,X,X
X,X,X,A,A,B,C,B,A,A,X,X,X
X,X,X,X,A,A,B,A,A,X,X,X,X
X,X,X,X,X,X,A,X,X,X,X,X,X
X,X,X,X,X,X,X,X,X,X,X,X,X
X,X,X,X,X,X,X,X,X,X,X,X,X
X,X,X,X,X,X,X,X,X,X,X,X,X
X,X,X,X,X,X,X,X,X,X,X,X,X
X,X,X,X,X,X,X,X,X,X,X,X,X
X,X,X,X,X,X,X,X,X,X,X,X,X