mapa uno
X,X,X,X,X,X,X,X,X,X,X,X,X
X,A,X,X,X,B,B,B,X,X,X,A,X
X,A,A,X,X,B,B,B,X,X,A,A,X
X,A,A,A,A,B,B,B,A,A,A,A,X
X,A,A,A,A,A,A,A,A,A,A,A,X
X,A,X,X,X,B,B,B,X,X,X,A,X
X,X,A,A,X,A,A,A,X,A,A,X,X
D,X,X,A,X,A,A,A,X,A,X,X,D
A,A,X,X,X,A,A,A,X,X,X,A,A
X,X,A,A,A,A,A,A,A,A,A,X,X
X,X,A,A,A,A,A,A,A,A,A,X,X
X,X,A,A,X,A,A,A,X,A,A,X,X
X,X,A,A,X,A,A,A,X,A,A,X,X
X,X,X,X,X,A,A,A,X,X,X,X,X
X,X,X,X,X,X,X,X,X,X,X,X,X
X,X,X,X,X,X,X,X,X,X,X,X,X
X,X,X,X,X,X,X,X,X,X,X,X,X
X,X,X,X,X,X,X,X,X,X,X,X,X